################################
#..............................#
#..............................#
#.....####.....................#
#..............................#
#..................####........#
#..............................#
#..............................#
#............####..............#
#..............................#
#........#.....................#
#.....####.....................#
#..............................#
#..............................#
################################
