BBBBBBBBBBBBBBBBBBBBBBBBBBBBBBBB
G..............................G
G..............................G
G.....RRRR.....................G
G..............................G
G..................RRRR........G
G..............................G
G..............................G
G............RRRR..............G
G..............................G
G........R.....................G
G.....RRRR.....................G
G..............................G
G..............................G
DDDDDDDDDDDDDDDDDDDDDDDDDDDDDDDD
